000, 000, 000, 000, 010, 000, 000, 000, 000, 000
000, 000, 000, 000, 010, 000, 000, 000, 000, 000
000, 000, 000, 000, 020, 000, 000, 000, 000, 000
000, 000, 000, 000, 050, 000, 000, 000, 000, 000
000, 000, 000, 000, 070, 000, 000, 000, 000, 000
200, 090, 100, 090, 080, 010, 020, 020, 010, 200
000, 000, 000, 000, 020, 000, 000, 000, 000, 000
000, 000, 000, 000, 010, 000, 000, 000, 000, 000
000, 000, 000, 000, 010, 000, 000, 000, 000, 000
000, 000, 000, 000, 300, 000, 000, 000, 000, 000